#..##..#.##
..#.#.##..#
#.#..#.....
#..#.#.##..
..##....##.
.#..##..##.
#...#.#.#.#
....#....#.
#.#....#.#.
.#..#.#....
.###...#..#
